000000000000000000000000000000000000000000000000000000000000000000000000000000000000000000000000000000000000000000000000
000000000000000000000000000000000000000000000000000000000000000000000000000000000000000000000000000000000000000000000000
000000000000000000000000000000000000000000000000000000000000000000000000000000000000000000000000000000000000000000000000
000000000000000000000000000000000000000000000000000000000000000000000000000000000000000000000000000000000000000000000000
000000000000000000000000000000000000000000000000000000000000000000000000000000000000000000000000000000000000000000000000
000000000000000000000000000000000000000000000000000000000000000000000000000000000000000000000000000000000000000000000000
000000000000000000000000000000000000000000000000000000000000000000000000000000000000000000000000000000000000000000000000
000000000000000000000000000000000000000000000000000000000000000000000000000000000000000000000000000000000000000000000000
000000000000000000000000000000000000000000000000000000000000000000000000000000000000000000000000000000000000000000000000
000000000000000000000000000000000000000000000000000000000000000000000000000000000000000000000000000000000000000000000000
0000000000000000000000000000000000005116000000000000000000000000000000000000000000000000000000511160000000pq000000000000
0000000n00000000005111160000000005111168600000000000000000000000000000000000000000000511160000322270n00000rs000000000000
00009a0o00000000003222270000000003222272700000000000000000000000000000000000000000000322270000322270o00000rs000000000000
111111111111111111422228111111111111111111600000051111600560056005111111111111111111111111111142228111111111111111111111
222222222222222222222222222222222222222222811111142222700381147003222222222222222222222222222222222222222222222222222222
4 490 320 2272 288 2176 320 2368 320
1 430 350 430 0 1120 300 1504 448 2496 428 3104 320
6 160 352 149 352 138 352 637 260 651 260 665 260
1 2496 300
